{
  "world": [
    {
      "x": 0,
      "y": 0,
      "resources": [
        {
          "local_x": 0,
          "local_y": 0,
          "item_type": "wood",
          "uid": "40330c16-304d-47e9-8f8f-361991c31282"
        }
      ],
      "background_layer": [
        [2, 2, 2, 2, 2, 1, 1, 1],
        [2, 2, 2, 2, 1, 1, 1, 1],
        [2, 2, 2, 1, 2, 1, 1, 1],
        [2, 2, 1, 1, 2, 1, 1, 1],
        [2, 1, 1, 1, 2, 1, 1, 1],
        [1, 2, 1, 2, 2, 1, 1, 1],
        [1, 1, 1, 1, 2, 1, 1, 1],
        [1, 1, 1, 1, 2, 1, 1, 1]
      ],
      "foreground_layer": [
        [0, 0, 0, 0, 0, 0, 0, 0],
        [0, 0, 0, 0, 0, 0, 0, 0],
        [0, 0, 0, 0, 0, 0, 0, 0],
        [0, 0, 0, 0, 0, 0, 0, 0],
        [0, 0, 0, 0, 0, 0, 0, 0],
        [0, 0, 0, 0, 0, 0, 0, 0],
        [0, 0, 0, 0, 0, 0, 0, 0],
        [0, 0, 0, 0, 0, 0, 0, 0]
      ]
    },
    {
      "x": -1,
      "y": 0,
      "resources": [
        {
          "local_x": 0,
          "local_y": 0,
          "item_type": "wood",
          "uid": "40330c16-304d-47e9-8f8f-361991c31282"
        }
      ],
      "background_layer": [
        [2, 2, 2, 2, 2, 1, 1, 1],
        [2, 2, 2, 2, 1, 1, 1, 1],
        [2, 2, 2, 1, 2, 1, 1, 1],
        [2, 2, 1, 1, 2, 1, 1, 1],
        [2, 1, 1, 1, 2, 1, 1, 1],
        [1, 2, 1, 2, 2, 1, 1, 1],
        [1, 1, 1, 1, 2, 1, 1, 1],
        [1, 1, 1, 1, 2, 1, 1, 1]
      ],
      "foreground_layer": [
        [0, 0, 0, 0, 0, 0, 0, 0],
        [0, 0, 0, 0, 0, 0, 0, 0],
        [0, 0, 0, 0, 0, 0, 0, 0],
        [0, 0, 0, 0, 0, 0, 0, 0],
        [0, 0, 0, 0, 0, 0, 0, 0],
        [0, 0, 0, 0, 0, 0, 0, 0],
        [0, 0, 0, 0, 0, 0, 0, 0],
        [0, 0, 0, 0, 0, 0, 0, 0]
      ]
    }
  ],
  "name": "test_map"
}
